"aa" = (/turf/space,/area/space)
"ab" = (/obj/machinery/recharge_station,/turf/simulated/floor/plating{icon_state = "warnplate"; dir = 4},/area/space)
"ac" = (/obj/effect/decal/cleanable/dirt,/turf/simulated/floor{icon_state = "floorgrime"},/area/space)
"ad" = (/obj/machinery/button/remote/blast_door{dir = 2; id = "Skynet_launch"; name = "Mech Bay Door Control"; pixel_x = 6; pixel_y = 24; req_access = list(29)},/obj/machinery/light_switch{pixel_x = -6; pixel_y = 28},/turf/simulated/floor{tag = "icon-warningcorner (WEST)"; icon_state = "warningcorner"; dir = 8},/area/space)
"ae" = (/obj/machinery/atmospherics/unary/vent_scrubber/on,/turf/simulated/floor{dir = 1; icon_state = "warning"},/area/space)
"af" = (/obj/item/device/radio/intercom{dir = 8; name = "Station Intercom (General)"; pixel_x = 28},/turf/simulated/floor{dir = 1; icon_state = "warning"},/area/space)
"ag" = (/turf/simulated/wall,/area/space)
"ah" = (/obj/structure/table/standard,/obj/item/weapon/retractor,/obj/item/weapon/hemostat,/obj/item/weapon/scalpel{pixel_y = 12},/obj/item/weapon/circular_saw,/obj/structure/window/reinforced,/turf/simulated/floor{icon_state = "white"},/area/space)
"ai" = (/turf/simulated/floor{icon_state = "white"},/area/space)
"aj" = (/turf/simulated/wall/r_wall,/area/space)
"ak" = (/obj/machinery/atmospherics/unary/vent_scrubber/on,/obj/machinery/photocopier,/turf/simulated/floor{dir = 1; icon_state = "whitepurple"},/area/space)
"al" = (/obj/structure/bed/chair/office/light{dir = 1},/turf/simulated/floor{dir = 1; icon_state = "whitepurple"},/area/space)
"am" = (/obj/structure/filingcabinet/chestdrawer,/turf/simulated/floor{dir = 1; icon_state = "whitepurple"},/area/space)
"an" = (/turf/simulated/floor/bluegrid,/area/space)
"ao" = (/obj/machinery/atmospherics/pipe/simple/hidden/supply{dir = 6},/obj/machinery/atmospherics/pipe/simple/hidden/scrubbers{dir = 5},/turf/simulated/floor,/area/space)
"ap" = (/obj/machinery/atmospherics/pipe/simple/hidden/scrubbers{dir = 4},/obj/machinery/atmospherics/pipe/simple/hidden/supply{dir = 4},/turf/simulated/floor,/area/space)
"aq" = (/obj/machinery/door/firedoor/border_only{dir = 4; name = "hazard door east"},/obj/machinery/door/airlock/glass_research{name = "Robotics Lab"; req_access = list(29)},/obj/machinery/atmospherics/pipe/simple/hidden/scrubbers{dir = 4},/obj/machinery/atmospherics/pipe/simple/hidden/supply{dir = 4},/turf/simulated/floor{icon_state = "white"},/area/space)
"ar" = (/obj/machinery/atmospherics/pipe/simple/hidden/scrubbers{dir = 4},/obj/machinery/atmospherics/pipe/simple/hidden/supply{dir = 4},/turf/simulated/floor{icon_state = "white"},/area/space)
"as" = (/obj/machinery/atmospherics/pipe/simple/hidden/supply{dir = 4},/obj/machinery/atmospherics/pipe/simple/hidden/scrubbers{dir = 4},/turf/simulated/floor{icon_state = "white"},/area/space)
"at" = (/obj/machinery/power/apc{dir = 1; name = "north bump"; pixel_x = 0; pixel_y = 24},/obj/machinery/camera/network/research{c_tag = "Research - Robotics"},/obj/machinery/atmospherics/pipe/simple/hidden/supply{dir = 4},/obj/machinery/atmospherics/pipe/simple/hidden/scrubbers{dir = 4},/obj/structure/cable/green{d2 = 4; icon_state = "0-4"},/turf/simulated/floor{icon_state = "white"},/area/space)
"au" = (/obj/machinery/atmospherics/pipe/manifold/hidden/scrubbers{dir = 4},/obj/machinery/atmospherics/pipe/simple/hidden/supply{dir = 10},/obj/structure/cable/green{d1 = 2; d2 = 8; icon_state = "2-8"},/turf/simulated/floor{icon_state = "white"},/area/space)
"av" = (/obj/machinery/firealarm{dir = 4; pixel_x = 24},/obj/structure/table/rack{dir = 8; layer = 2.9},/obj/item/weapon/storage/toolbox/electrical{pixel_x = 1; pixel_y = 6},/obj/item/clothing/head/welding{pixel_x = -3; pixel_y = 5},/obj/item/weapon/storage/toolbox/mechanical,/obj/item/weapon/storage/toolbox/mechanical{pixel_x = -2; pixel_y = -1},/obj/item/weapon/storage/toolbox/mechanical{pixel_x = -2; pixel_y = -1},/obj/item/stack/cable_coil,/obj/machinery/light{dir = 4; icon_state = "tube1"; pixel_x = 0},/turf/simulated/floor{icon_state = "white"},/area/space)
"aw" = (/obj/machinery/mech_bay_recharge_port,/obj/machinery/light{dir = 8; icon_state = "tube1"; pixel_y = 0},/turf/simulated/floor/plating{icon_state = "warnplate"; dir = 6},/area/space)
"ax" = (/turf/simulated/floor/mech_bay_recharge_floor,/area/space)
"ay" = (/obj/machinery/computer/mech_bay_power_console,/turf/simulated/floor/bluegrid,/area/space)
"az" = (/obj/machinery/atmospherics/pipe/simple/hidden/supply,/turf/simulated/floor{icon_state = "floorgrime"},/area/space)
"aA" = (/obj/effect/decal/cleanable/generic,/obj/machinery/light{dir = 4; icon_state = "tube1"; pixel_x = 0},/turf/simulated/floor{icon_state = "floorgrime"},/area/space)
"aB" = (/obj/machinery/door/firedoor/border_only{dir = 2},/turf/simulated/floor/plating/with_grille/reinforced,/area/space)
"aC" = (/obj/structure/table/glass,/obj/item/device/robotanalyzer,/obj/item/device/mmi/digital/posibrain,/turf/simulated/floor{icon_state = "white"},/area/space)
"aD" = (/obj/structure/table/glass,/obj/item/device/flash/synthetic,/obj/item/device/flash/synthetic,/obj/item/device/flash/synthetic,/obj/item/device/flash/synthetic,/obj/item/device/flash{pixel_x = 5; pixel_y = 5},/obj/item/device/flash{pixel_x = 5; pixel_y = 5},/obj/item/device/assembly/prox_sensor{pixel_x = -8; pixel_y = 4},/obj/item/device/assembly/prox_sensor{pixel_x = -8; pixel_y = 4},/obj/item/device/assembly/prox_sensor{pixel_x = -8; pixel_y = 4},/obj/item/device/assembly/prox_sensor{pixel_x = -8; pixel_y = 4},/turf/simulated/floor{icon_state = "white"},/area/space)
"aE" = (/obj/structure/table/glass,/obj/item/device/mmi,/obj/item/device/mmi,/obj/item/device/mmi,/turf/simulated/floor{icon_state = "white"},/area/space)
"aF" = (/obj/machinery/atmospherics/unary/vent_pump/on{dir = 4},/turf/simulated/floor{icon_state = "white"},/area/space)
"aG" = (/obj/machinery/atmospherics/pipe/simple/hidden/scrubbers,/obj/machinery/atmospherics/pipe/manifold/hidden/supply{dir = 4},/obj/structure/cable/green{d1 = 1; d2 = 2; icon_state = "1-2"},/turf/simulated/floor{icon_state = "white"},/area/space)
"aH" = (/obj/structure/bed/chair/office/light{dir = 4},/obj/effect/landmark/start{name = "Roboticist"},/turf/simulated/floor{icon_state = "white"},/area/space)
"aI" = (/obj/machinery/ai_status_display{pixel_x = 32; pixel_y = 0},/obj/machinery/computer/rdconsole/robotics,/turf/simulated/floor{icon_state = "white"},/area/space)
"aJ" = (/obj/structure/extinguisher_cabinet{pixel_x = -27},/turf/simulated/floor{icon_state = "floorgrime"},/area/space)
"aK" = (/obj/effect/decal/cleanable/generic,/turf/simulated/floor{icon_state = "floorgrime"},/area/space)
"aL" = (/obj/machinery/cell_charger,/obj/item/weapon/cell/high{charge = 100; maxcharge = 15000; pixel_x = 5; pixel_y = 5},/obj/item/weapon/cell/high{charge = 100; maxcharge = 15000; pixel_x = 5; pixel_y = -5},/obj/structure/table/steel,/obj/structure/cable/green{d1 = 2; d2 = 4; icon_state = "2-4"},/turf/simulated/floor,/area/space)
"aM" = (/obj/structure/cable/green{d1 = 4; d2 = 8; icon_state = "4-8"},/obj/machinery/door/firedoor/border_only{dir = 2},/turf/simulated/floor/plating/with_grille/reinforced,/area/space)
"aN" = (/obj/structure/cable/green{d1 = 4; d2 = 8; icon_state = "4-8"},/obj/structure/table/glass,/obj/item/device/destTagger{pixel_x = 4; pixel_y = 3},/obj/structure/disposalpipe/segment{dir = 4; icon_state = "pipe-c"},/obj/item/weapon/packageWrap,/turf/simulated/floor{icon_state = "white"},/area/space)
"aO" = (/obj/effect/landmark/start{name = "Roboticist"},/obj/structure/cable/green{d1 = 4; d2 = 8; icon_state = "4-8"},/obj/structure/bed/chair/office/light{dir = 8},/obj/structure/disposalpipe/segment{dir = 4},/turf/simulated/floor{icon_state = "white"},/area/space)
"aP" = (/obj/structure/cable/green{d1 = 4; d2 = 8; icon_state = "4-8"},/obj/structure/disposalpipe/segment{dir = 4},/turf/simulated/floor{icon_state = "white"},/area/space)
"aQ" = (/obj/structure/cable/green{d1 = 4; d2 = 8; icon_state = "4-8"},/obj/machinery/hologram/holopad,/obj/structure/disposalpipe/segment{dir = 4},/turf/simulated/floor{icon_state = "white"},/area/space)
"aR" = (/obj/structure/cable/green{d1 = 2; d2 = 8; icon_state = "2-8"},/obj/machinery/atmospherics/pipe/simple/hidden/supply,/obj/machinery/atmospherics/pipe/simple/hidden/scrubbers,/obj/structure/cable/green{d1 = 1; d2 = 2; icon_state = "1-2"},/obj/structure/disposalpipe/segment{dir = 2; icon_state = "pipe-c"},/turf/simulated/floor{icon_state = "white"},/area/space)
"aS" = (/obj/item/device/radio/intercom{freerange = 0; frequency = 1459; name = "Station Intercom (General)"; pixel_x = 29},/obj/machinery/r_n_d/circuit_imprinter,/obj/item/weapon/reagent_containers/glass/beaker/sulphuric,/turf/simulated/floor{icon_state = "white"},/area/space)
"aT" = (/obj/machinery/mech_bay_recharge_port,/obj/machinery/camera/network/research{c_tag = "Research - Mech Bay"; dir = 4},/turf/simulated/floor/plating{icon_state = "warnplate"; dir = 5},/area/space)
"aU" = (/obj/structure/cable/green{d1 = 1; d2 = 2; icon_state = "1-2"},/obj/structure/table/steel,/obj/item/stack/material/steel{amount = 10; pixel_x = 5; pixel_y = -4},/obj/item/stack/material/plasteel{amount = 10},/turf/simulated/floor{icon_state = "floorgrime"},/area/space)
"aV" = (/obj/machinery/disposal,/obj/structure/disposalpipe/trunk{dir = 1},/turf/simulated/floor{tag = "icon-warnplate (NORTHWEST)"; icon_state = "warnplate"; dir = 9},/area/space)
"aW" = (/turf/simulated/floor/plating{dir = 1; icon_state = "warnplate"; nitrogen = 0.01; oxygen = 0.01},/area/space)
"aX" = (/obj/item/stack/material/steel{amount = 50},/obj/item/stack/material/steel{amount = 50},/obj/item/stack/material/steel{amount = 50},/obj/item/stack/material/steel{amount = 50},/obj/item/stack/material/steel{amount = 50},/obj/item/stack/material/steel{amount = 50},/obj/item/stack/material/steel{amount = 50},/obj/item/stack/material/steel{amount = 50},/obj/structure/table/steel,/turf/simulated/floor/plating{icon_state = "warnplate"; dir = 5},/area/space)
"aY" = (/turf/simulated/floor/plating/with_grille/reinforced,/area/space)
"aZ" = (/obj/structure/cable/green{d1 = 1; d2 = 2; icon_state = "1-2"},/obj/machinery/atmospherics/pipe/simple/hidden/supply,/obj/machinery/atmospherics/pipe/simple/hidden/scrubbers,/obj/structure/disposalpipe/segment,/turf/simulated/floor{icon_state = "white"},/area/space)
"ba" = (/obj/structure/table/glass,/obj/machinery/cell_charger,/obj/item/weapon/cell/high{charge = 100; maxcharge = 15000; pixel_x = 5; pixel_y = 5},/turf/simulated/floor{icon_state = "white"},/area/space)
"bb" = (/obj/effect/decal/cleanable/blood/oil/streak,/obj/structure/reagent_dispensers/fueltank,/turf/simulated/floor/plating{icon_state = "warnplate"; dir = 6},/area/space)
"bc" = (/obj/machinery/atmospherics/pipe/simple/hidden/supply,/turf/simulated/floor,/area/space)
"bd" = (/obj/machinery/alarm{dir = 8; icon_state = "alarm0"; pixel_x = 24},/obj/structure/cable/green{d1 = 1; d2 = 2; icon_state = "1-2"},/obj/effect/decal/cleanable/generic,/obj/structure/table/steel,/obj/item/weapon/storage/belt/utility,/turf/simulated/floor{icon_state = "floorgrime"},/area/space)
"be" = (/turf/simulated/floor/plating{dir = 4; icon_state = "warnplatecorner"},/area/space)
"bf" = (/turf/simulated/floor/plating,/area/space)
"bg" = (/obj/structure/table/steel,/obj/item/weapon/book/manual/robotics_cyborgs{pixel_x = 4; pixel_y = 5},/obj/item/stack/material/glass{amount = 30; pixel_x = -3; pixel_y = 3},/turf/simulated/floor/plating{dir = 8; icon_state = "warnplatecorner"},/area/space)
"bh" = (/obj/machinery/newscaster{pixel_x = 26; pixel_y = 1},/obj/structure/table/glass,/obj/item/weapon/stock_parts/manipulator,/obj/item/weapon/stock_parts/manipulator,/obj/item/weapon/storage/firstaid,/turf/simulated/floor{icon_state = "white"},/area/space)
"bi" = (/obj/machinery/atmospherics/pipe/simple/hidden/supply{dir = 6},/obj/effect/decal/cleanable/dirt,/turf/simulated/floor{icon_state = "floorgrime"},/area/space)
"bj" = (/obj/machinery/atmospherics/pipe/simple/hidden/supply{dir = 4},/obj/machinery/light,/turf/simulated/floor{icon_state = "floorgrime"},/area/space)
"bk" = (/obj/machinery/atmospherics/pipe/simple/hidden/supply{dir = 9; pixel_y = 0},/turf/simulated/floor{icon_state = "floorgrime"},/area/space)
"bl" = (/obj/machinery/power/apc{dir = 4; name = "east bump"; pixel_x = 24},/obj/structure/cable/green,/turf/simulated/floor{icon_state = "floorgrime"},/area/space)
"bm" = (/obj/machinery/mecha_part_fabricator{pixel_y = -2},/turf/simulated/floor/plating,/area/space)
"bn" = (/obj/machinery/conveyor_switch{id = "robo"; pixel_x = -8; pixel_y = -3},/turf/simulated/floor/plating,/area/space)
"bo" = (/obj/structure/table/glass,/obj/item/weapon/storage/belt/utility,/obj/item/device/multitool,/obj/item/clothing/glasses/welding,/obj/machinery/light{dir = 4; icon_state = "tube1"; pixel_x = 0},/turf/simulated/floor{icon_state = "white"},/area/space)
"bp" = (/obj/machinery/cryopod/robot/right,/turf/simulated/floor,/area/space)
"bq" = (/obj/machinery/atmospherics/unary/vent_pump/on{dir = 1},/obj/effect/landmark{name = "JoinLateCyborg"},/obj/machinery/computer/cryopod/robot{pixel_y = -30},/obj/machinery/firealarm{dir = 4; layer = 3.3; pixel_x = 26},/turf/simulated/floor,/area/space)
"br" = (/obj/machinery/conveyor{dir = 4; id = "robo"},/turf/simulated/floor/plating{icon_state = "warnplate"; dir = 9},/area/space)
"bs" = (/obj/machinery/conveyor{dir = 4; id = "robo"},/turf/simulated/floor/plating{icon_state = "warnplate"; dir = 1},/area/space)
"bt" = (/obj/machinery/conveyor{dir = 4; id = "robo"},/obj/structure/plasticflaps,/turf/simulated/floor/plating{icon_state = "warnplate"; dir = 1},/area/space)
"bu" = (/obj/machinery/conveyor{dir = 4; id = "robo"},/obj/structure/sign/nosmoking_2{pixel_y = -32},/turf/simulated/floor/plating{icon_state = "warnplate"; dir = 1},/area/space)
"bv" = (/obj/machinery/conveyor{dir = 4; id = "robo"},/obj/machinery/light,/turf/simulated/floor/plating{icon_state = "warnplate"; dir = 1},/area/space)
"bw" = (/obj/structure/cable/green{d1 = 1; d2 = 2; icon_state = "1-2"},/obj/machinery/atmospherics/pipe/simple/hidden/scrubbers,/obj/machinery/atmospherics/pipe/simple/hidden/supply,/obj/machinery/light_switch{pixel_x = -23; pixel_y = 0},/obj/structure/disposalpipe/segment,/turf/simulated/floor{icon_state = "white"},/area/space)
"bx" = (/obj/structure/closet/wardrobe/robotics_black,/turf/simulated/floor{icon_state = "white"},/area/space)
"by" = (/turf/simulated/floor,/area/space)
"bz" = (/obj/machinery/atmospherics/unary/vent_scrubber/on{dir = 1},/turf/simulated/floor,/area/space)
"bA" = (/turf/simulated/floor{dir = 1; icon_state = "loadingarea"},/area/space)
"bB" = (/obj/structure/sign/securearea{pixel_x = 32},/turf/simulated/floor{dir = 1; icon_state = "loadingarea"},/area/space)
"bC" = (/turf/simulated/floor{dir = 10; icon_state = "purple"},/area/space)
"bD" = (/turf/simulated/floor{dir = 2; icon_state = "purple"},/area/space)
"bE" = (/turf/simulated/floor/plating/with_grille/tinted,/area/space)
"bF" = (/obj/structure/curtain/medical,/turf/simulated/floor{icon_state = "white"},/area/space)
"bG" = (/obj/structure/table/standard,/obj/item/weapon/retractor,/obj/item/weapon/hemostat,/obj/item/weapon/scalpel{pixel_y = 12},/obj/item/weapon/circular_saw,/turf/simulated/floor{icon_state = "white"},/area/space)
"bH" = (/obj/structure/table/standard,/obj/item/weapon/storage/box/bodybags,/turf/simulated/floor{icon_state = "white"},/area/space)
"bI" = (/obj/structure/table/standard,/turf/simulated/floor{icon_state = "white"},/area/space)
"bJ" = (/obj/machinery/optable{name = "Robotics Operating Table"},/turf/simulated/floor{icon_state = "white"},/area/space)
"bK" = (/obj/machinery/computer/operating{name = "Robotics Operating Computer"},/turf/simulated/floor{icon_state = "white"},/area/space)
"bL" = (/obj/machinery/mech_bay_recharge_port,/turf/simulated/floor/plating{icon_state = "warnplate"; dir = 6},/area/space)

(1,1,1) = {"
aaaaaaaaabacadaeafagahaiaiaiajakalamaaaa
aaaaaaaaabananaoapaqarararasatauaiavaaaa
aaaaaaaaawaxayazaAaBaCaDaEaiaFaGaHaIaaaa
aaaaaaaaaJacaKazaLaMaNaOaPaPaQaRaiaSaaaa
aaaaaaaaaTaxayazaUaBaVaWaWaXaYaZaibaaaaa
aaaaaaaabbananbcbdagbebfbfbgaYaZaibhaaaa
aaaaaaaaacbibjbkblagbmbmbnbfaYaZaiboaaaa
aaaaaaaabpbqagbrbsbtbsbubvbsagbwaibxaaaa
aaaaaaaaaaaaaaaaaaaaaaaaaaaaaaaaaaaaaaaa
aabybybzbAbBajajajajajajbCbDbDaaaaaaaaaa
aaajajajajajajaiaiaiaiajajajajaaaaaaaaaa
aaaiaiaiaiaiaiaiaiaiaiaiaiaiaiaaaaaaaaaa
aaaiaiaiaiaiaiaiaiaiaiaiaiaiaiaaaaaaaaaa
aaaiaiaiaiaiaiaiaiaiaiaiaiaiaiaaaaaaaaaa
aaaiaiaiaiaiaiaiaiaiaiaiaiaiaiaaaaaaaaaa
aabEbFbFbEaiaiaiaiaiaiaiaiaiaiaaaaaaaaaa
aabGaiaibEaiaiaiaiaiaiaiaiaiaiaaaaaaaaaa
aabHaiaibEaiaiaiaiaiaiaiaiaiaiaaaaaaaaaa
aabIbJbKbEaiaibLaxayaiaiaiaiaiaaaaaaaaaa
aaaaaaaaaaaaaaaaaaaaaaaaaaaaaaaaaaaaaaaa
"}

