"a" = (/turf/space,/area/space)
"b" = (/turf/simulated/wall/r_wall,/area/space)
"c" = (/turf/simulated/floor,/area/shuttle/arrival/station)
"d" = (/turf/simulated/wall/r_wall,/area/shuttle/arrival/station)
"e" = (/turf/simulated/floor,/area/hallway/primary/port)
"f" = (/obj/effect/landmark/start,/turf/simulated/floor,/area/shuttle/arrival/station)
"g" = (/turf/simulated/floor,/area/hallway/primary/aft)
"h" = (/turf/simulated/wall/r_wall,/area/hallway/primary/aft)
"i" = (/turf/simulated/wall/r_wall,/area/hallway/primary/fore)
"j" = (/turf/simulated/floor,/area/hallway/primary/fore)
"k" = (/turf/simulated/wall/r_wall,/area/hallway/primary/starboard)
"l" = (/turf/simulated/floor,/area/hallway/primary/starboard)

(1,1,1) = {"
aaaaaaaaaaaaaaaaaaaaaaaaaaaaaaaaaaaaaaaaaaaaaaaaaaaaaaaaaaaaaaaaaaaaaa
aaaaaaaaaaaaaaaaaaaaaaaaaaaaaaaaaaaaaaaaaaaaaaaaaaaaaaaaaaaaaaaaaaaaaa
aaaaaaaaaaaaaaaaaaaaaaaaaaaaaaaaaaaaaaaaaaaaaaaaaaaaaaaaaaaaaaaaaaaaaa
aaaaaaaaaaaaaaaaaaaaaaaaaaaaaaaaaaaaaaaaaaaaaaaaaaaaaaaaaaaaaaaaaaaaaa
aaaaaaaaaaaaaaaaaaaaaaaaaaaaaaaaaaaaaaaaaaaaaaaaaaaaaaaaaaaaaaaaaaaaaa
aaaaaaaaaaaaaaaaaaaaaaaaaaaaaaaaaaaaaaaaaaaaaaaaaaaaaaaaaaaaaaaaaaaaaa
aaaaaaaaaaaaaaaaaaaaaaaaaaaaaaaaaaaaaaaaaaaaaaaaaaaaaaaaaaaaaaaaaaaaaa
aaaaaaaaaaaaaaaaaaaaaaaaaaaaaaaaaaaaaaaaaaaaaaaaaaaaaaaaaaaaaaaaaaaaaa
aaaaaaaaaaaaaaaaaaaaaaaaaaaaaaaaaaaaaaaaaaaaaaaaaaaaaaaaaaaaaaaaaaaaaa
aaaaaaaaaaaaaaaaaaaaaaaaaaaaaaaaaaaaaaaaaaaaaaaaaaaaaaaaaaaaaaaaaaaaaa
aaaaaaaaaaaaaaaaaaaaaaaaaaaaaaaaaaaaaaaaaaaaaaaaaaaaaaaaaaaaaaaaaaaaaa
aaaaaaaaaaaaaaaaaaaaaaaaaaaaaaaaaaaaaaaaaaaaaaaaaaaaaaaaaaaaaaaaaaaaaa
aaaaaaaaaaaaaaaaaaaaaaaaaaaaaaaaaaaaaaaaaaaaaaaaaaaaaaaaaaaaaaaaaaaaaa
aaaaaaaaaaaaaaaaaaaaaaaaaaaaaaaaaaaaaaaaaaaaaaaaaaaaaaaaaaaaaaaaaaaaaa
aaaaaaaaaaaaaaaaaaaaaaaaaaaaaaaaaaaaaaaaaaaaaaaaaaaaaaaaaaaaaaaaaaaaaa
aaaaaaaaaaaaaaaaaaaaaaaaaaaaaaaaaaaaaaaaaaaaaaaaaaaaaaaaaaaaaaaaaaaaaa
aaaaaaaaaaaaaaaaaaaaaaaaaaaaaaaaaaaaaaaaaaaaaaaaaaaaaaaaaaaaaaaaaaaaaa
aaaaaaaaaaaaaaaaaaaaaaaaaaaaaaaaaaaaaaaaaaaaaaaaaaaaaaaaaaaaaaaaaaaaaa
aaaaaaaaaaaaaaaaaaaaaaaaaaaaaaaaaaaaaaaaaaaaaaaaaaaaaaaaaaaaaaaaaaaaaa
aaaaaaaaaaaaaaaaaaaaaaaaaaaaaaaaaaaaaaaaaaaaaaaaaaaaaaaaaaaaaaaaaaaaaa
aaaaaaaaaaaaaaaaaaaaaaaaaaaaaaaaaaaaaaaaaaaaaaaaaaaaaaaaaaaaaaaaaaaaaa
aaaaaaaaaaaaaaaaaaaaaaaaaaaaaaaaaaaaaaaaaaaaaaaaaaaaaaaaaaaaaaaaaaaaaa
aaaaaaaaaaaaaaaaaaaaaaaaaaaaaaaaaaaaaaaaaaaaaaaaaaaaaaaaaaaaaaaaaaaaaa
abbbbbbbbbbbbbbbbbbbbbbbbbbbbbbbbbbbbbbbbbbbbbbbbbbbbbbaaaaaaaaaaaaaaa
abcccccccccccccccdeeeeeeeeeeeeeeeeeeeeeeeeeeeeeeeeeeeebaaaaaaaaaaaaaaa
abcccccccccccccccdeeeeeeeeeeeeeeeeeeeeeeeeeeeeeeeeeeeebaaaaaaaaaaaaaaa
abcccccccccccccccdeeeeeeeeeeeeeeeeeeeeeeeeeeeeeeeeeeeebaaaaaaaaaaaaaaa
abcccccccccccccccdeeeeeeeeeeeeeeeeeeeeeeeeeeeeeeeeeeeebaaaaaaaaaaaaaaa
abcccccccccccccccceeeeeeeeeeeeeeeeeeeeeeeeeeeeeeeeeeeebaaaaaaaaaaaaaaa
abccccccfccccccccceeeeeeeeeeeeeeeeeeeeeeeeeeeeeeeeeeeebaaaaaaaaaaaaaaa
abcccccccccccccccdeeeeeeeeeeeeeeeeeeeeeeeeeeeeeeeeeeeebaaaaaaaaaaaaaaa
abcccccccccccccccdeeeeeeeeeeeeeeeeeeeeeeeeeeeeeeeeeeeebaaaaaaaaaaaaaaa
abcccccccccccccccdeeeeeeeeeeeeeeeeeeeeeeeeeeeeeeeeeeeebaaaaaaaaaaaaaaa
abcccccccccccccccdeeeeeeeeeeeeeeeeeeeeeeeeeeeeeeeeeeeebaaaaaaaaaaaaaaa
abcccccccccccccccdeeeeeeeeeeeeeeeeeeeeeeeeeeeeeeeeeeeebaaaaaaaaaaaaaaa
abddddddccddddddddeeeeeeeeeeeeeeeeeeeeeeeeeeeeeeeeeeeebaaaaaaaaaaaaaaa
abgggggggggggggggheeeeeeeeeeeeeeeeeeeeeeeeeeeeeeeeeeeebaaaaaaaaaaaaaaa
abgggggggggggggggheeeeeeeeeeeeeeeeeeeeeeeeeeeeeeeeeeeebaaaaaaaaaaaaaaa
abgggggggggggggggheeeeeeeeeeeeeeeeeeeeeeeeeeeeeeeeeeeebaaaaaaaaaaaaaaa
abgggggggggggggggheeeeeeeeeeeeeeeeeeeeeeeeeeeeeeeeeeeebaaaaaaaaaaaaaaa
abgggggggggggggggheeeeeeeeeeeeeeeeeeeeeeeeeeeeeeeeeeeebaaaaaaaaaaaaaaa
abgggggggggggggggheeeeeeeeeeeeeeeeeeeeeeeeeeeeeeeeeeeebaaaaaaaaaaaaaaa
abgggggggggggggggheeeeeeeeeeeeeeeeeeeeeeeeeeeeeeeeeeeebaaaaaaaaaaaaaaa
abgggggggggggggggheeeeeeeeeeeeeeeeeeeeeeeeeeeeeeeeeeeebaaaaaaaaaaaaaaa
abgggggggggggggggheeeeeeeeeeeeeeeeeeeeeeeeeeeeeeeeeeeebaaaaaaaaaaaaaaa
abgggggggggggggggheeeeeeeeeeeeeeeeeeeeeeeeeeeeeeeeeeeebaaaaaaaaaaaaaaa
abgggggggggggggggheeeeeeeeeeeeeeeeeeeeeeeeeeeeeeeeeeeebaaaaaaaaaaaaaaa
abgggggggggggggggheeeeeeeeeeeeeeeeeeeeeeeeeeeeeeeeeeeebaaaaaaaaaaaaaaa
abgggggggggggggggheeeeeeeeeeeeeeeeeeeeeeeeeeeeeeeeeeeebaaaaaaaaaaaaaaa
abgggggggggggggggheeeeeeeeeeeeeeeeeeeeeeeeeeeeeeeeeeeebaaaaaaaaaaaaaaa
abgggggggggggggggheeeeeeeeeeeeeeeeeeeeeeeeeeeeeeeeeeeebaaaaaaaaaaaaaaa
abiiiiiijjiiiiiiiijjikkkkkkkklllllkkkkkkkkkkkkkkkkkkkkbaaaaaaaaaaaaaaa
abjjjjjjjjjjjjjjjjjjilllllllllllllllllllllllllllllllllbaaaaaaaaaaaaaaa
abjjjjjjjjjjjjjjjjjjilllllllllllllllllllllllllllllllllbaaaaaaaaaaaaaaa
abjjjjjjjjjjjjjjjjjjilllllllllllllllllllllllllllllllllbaaaaaaaaaaaaaaa
abjjjjjjjjjjjjjjjjjjilllllllllllllllllllllllllllllllllbaaaaaaaaaaaaaaa
abjjjjjjjjjjjjjjjjjjilllllllllllllllllllllllllllllllllbaaaaaaaaaaaaaaa
abjjjjjjjjjjjjjjjjjjilllllllllllllllllllllllllllllllllbaaaaaaaaaaaaaaa
abjjjjjjjjjjjjjjjjjjilllllllllllllllllllllllllllllllllbaaaaaaaaaaaaaaa
abjjjjjjjjjjjjjjjjjjilllllllllllllllllllllllllllllllllbaaaaaaaaaaaaaaa
abjjjjjjjjjjjjjjjjjjilllllllllllllllllllllllllllllllllbaaaaaaaaaaaaaaa
abjjjjjjjjjjjjjjjjjjilllllllllllllllllllllllllllllllllbaaaaaaaaaaaaaaa
abjjjjjjjjjjjjjjjjjjilllllllllllllllllllllllllllllllllbaaaaaaaaaaaaaaa
abjjjjjjjjjjjjjjjjjjilllllllllllllllllllllllllllllllllbaaaaaaaaaaaaaaa
abjjjjjjjjjjjjjjjjjjilllllllllllllllllllllllllllllllllbaaaaaaaaaaaaaaa
abjjjjjjjjjjjjjjjjjjilllllllllllllllllllllllllllllllllbaaaaaaaaaaaaaaa
abbbbbbbbbbbbbbbbbbbbbbbbbbbbbbbbbbbbbbbbbbbbbbbbbbbbbbaaaaaaaaaaaaaaa
aaaaaaaaaaaaaaaaaaaaaaaaaaaaaaaaaaaaaaaaaaaaaaaaaaaaaaaaaaaaaaaaaaaaaa
aaaaaaaaaaaaaaaaaaaaaaaaaaaaaaaaaaaaaaaaaaaaaaaaaaaaaaaaaaaaaaaaaaaaaa
aaaaaaaaaaaaaaaaaaaaaaaaaaaaaaaaaaaaaaaaaaaaaaaaaaaaaaaaaaaaaaaaaaaaaa
"}

